date,--,Fenix,Firefox,Focus,MozillaVPN,ReferenceBrowser,Thunderbird,total
2023-03-31 00:00:00,0,28098,52967,580,4,0,18283,99932
2023-04-01 00:00:00,0,25747,36723,507,1,0,8211,71189
2023-04-02 00:00:00,0,24487,37095,592,0,0,6966,69140
2023-04-03 00:00:00,0,26738,57954,546,0,0,19883,105121
2023-04-04 00:00:00,0,26603,56622,538,0,0,18519,102282
2023-04-05 00:00:00,0,26349,52776,516,0,0,17574,97215
2023-04-06 00:00:00,0,24612,51291,602,3,0,16475,92983
2023-04-07 00:00:00,0,25149,43620,591,0,0,12518,81878
2023-04-08 00:00:00,0,26768,34994,575,0,0,6205,68542
2023-04-09 00:00:00,0,26485,31730,486,0,0,5132,63833
2023-04-10 00:00:00,0,26229,49325,541,0,0,13347,89442
2023-04-11 00:00:00,0,26089,59689,543,1,0,19668,105990
2023-04-12 00:00:00,0,27012,64456,548,0,0,20497,112513
2023-04-13 00:00:00,0,26529,60724,563,2,0,19661,107479
2023-04-14 00:00:00,0,25946,53583,660,1,0,17483,97673
2023-04-15 00:00:00,0,26021,37677,650,3,0,7902,72253
2023-04-16 00:00:00,0,26069,35337,604,4,0,7348,69362
2023-04-17 00:00:00,0,25677,60433,538,2,0,19425,106075
2023-04-18 00:00:00,0,26429,60263,589,4,0,19020,106305
2023-04-19 00:00:00,0,25491,57754,534,0,0,18584,102363
2023-04-20 00:00:00,0,26204,55690,556,0,0,18308,100758
2023-04-21 00:00:00,0,24386,48627,629,1,0,15743,89386
2023-04-22 00:00:00,0,25325,34189,614,0,0,6561,66689
2023-04-23 00:00:00,0,25765,35789,465,4,0,6559,68582
2023-04-24 00:00:00,0,26554,58171,550,0,0,18593,103868
2023-04-25 00:00:00,0,24949,56677,515,3,1,17490,99635
2023-04-26 00:00:00,0,26307,58627,578,4,0,19136,104652
2023-04-27 00:00:00,0,26541,56917,505,0,0,18351,102314
2023-04-28 00:00:00,0,24682,52558,557,2,0,16644,94443
2023-04-29 00:00:00,0,27119,35951,586,0,0,7107,70763
2023-04-30 00:00:00,0,25144,34167,610,0,0,6106,66027
2023-05-01 00:00:00,0,26271,40845,474,1,0,9636,77227
2023-05-02 00:00:00,0,27416,58403,518,1,0,19070,105408
2023-05-03 00:00:00,0,25300,55930,660,0,0,16206,98096
2023-05-04 00:00:00,0,25585,55160,605,0,0,16951,98301
2023-05-05 00:00:00,0,24048,52857,621,0,0,15322,92848
2023-05-06 00:00:00,0,25536,35439,587,3,0,6977,68542
2023-05-07 00:00:00,0,23843,33762,551,0,0,6862,65018
2023-05-08 00:00:00,0,25308,57987,486,3,0,18605,102389
2023-05-09 00:00:00,0,24404,63266,497,0,0,18299,106466
2023-05-10 00:00:00,0,24175,64358,506,0,0,19907,108946
2023-05-11 00:00:00,0,25759,60967,583,3,0,18164,105476
2023-05-12 00:00:00,0,25170,55294,498,3,0,16652,97617
2023-05-13 00:00:00,0,26937,37066,484,3,1,6562,71053
2023-05-14 00:00:00,0,26163,35067,546,0,0,6479,68255
2023-05-15 00:00:00,0,26354,61448,497,0,0,19228,107527
2023-05-16 00:00:00,0,26687,60070,554,3,0,17964,105278
2023-05-17 00:00:00,0,27009,54718,544,3,0,17321,99595
2023-05-18 00:00:00,0,27549,48472,513,0,0,14503,91037
2023-05-19 00:00:00,0,27170,48504,458,4,0,14721,90857
2023-05-20 00:00:00,0,27696,35209,544,3,0,6356,69808
2023-05-21 00:00:00,0,27682,33116,535,1,0,5914,67248
2023-05-22 00:00:00,0,27172,57831,493,0,0,18970,104466
2023-05-23 00:00:00,0,27534,56262,510,0,0,17451,101757
2023-05-24 00:00:00,0,28111,59648,572,0,0,17066,105397
2023-05-25 00:00:00,0,27741,56984,551,2,0,16575,101853
2023-05-26 00:00:00,0,26603,50208,464,4,0,15403,92682
2023-05-27 00:00:00,0,26883,34479,438,0,0,6336,68136
2023-05-28 00:00:00,0,25890,31926,557,0,0,5552,63925
2023-05-29 00:00:00,0,25433,47079,592,0,0,15275,88379
2023-05-30 00:00:00,0,26550,56048,612,0,0,18291,101501
2023-05-31 00:00:00,0,27996,54042,470,0,0,17856,100364
2023-06-01 00:00:00,0,25493,52136,509,0,0,16873,95011
2023-06-02 00:00:00,0,25007,48270,507,1,0,14669,88454
2023-06-03 00:00:00,0,24797,33607,530,2,0,6226,65162
2023-06-04 00:00:00,0,24028,30957,517,0,0,6123,61625
2023-06-05 00:00:00,0,24939,56924,493,0,0,18432,100788
2023-06-06 00:00:00,0,25122,55139,543,0,0,17763,98567
2023-06-07 00:00:00,0,25386,58601,455,3,0,17314,101759
2023-06-08 00:00:00,0,26405,53532,432,0,0,15153,95522
2023-06-09 00:00:00,0,24175,51706,550,0,0,15184,91615
2023-06-10 00:00:00,0,26753,34861,498,0,0,6262,68374
2023-06-11 00:00:00,0,25178,35336,538,1,0,6221,67274
2023-06-12 00:00:00,0,35280,59439,578,0,3,18192,113492
2023-06-13 00:00:00,0,29325,58971,520,1,1,18021,106839
2023-06-14 00:00:00,0,25481,60045,505,0,0,18393,104424
2023-06-15 00:00:00,0,25358,54815,583,2,3,16751,97512
2023-06-16 00:00:00,0,25636,51568,496,0,0,15181,92881
2023-06-17 00:00:00,0,25333,39178,451,1,0,6399,71362
2023-06-18 00:00:00,0,24959,38228,473,0,0,6685,70345
2023-06-19 00:00:00,0,24600,62681,385,0,0,18466,106132
2023-06-20 00:00:00,0,25971,62953,471,0,0,17616,107011
2023-06-21 00:00:00,0,24594,66186,489,0,0,16304,107573
2023-06-22 00:00:00,0,27108,66538,476,0,0,16074,110196
2023-06-23 00:00:00,0,25710,52487,484,0,0,14755,93436
2023-06-24 00:00:00,0,25284,34784,492,0,0,5920,66480
2023-06-25 00:00:00,0,24836,35839,515,3,0,5885,67078
2023-06-26 00:00:00,0,24364,60319,453,3,3,17490,102632
2023-06-27 00:00:00,0,24706,57669,522,0,0,16426,99323
2023-06-28 00:00:00,0,24409,53551,555,0,0,16464,94979
2023-06-29 00:00:00,0,23664,52169,494,3,0,15669,91999
2023-06-30 00:00:00,0,23787,50273,518,0,0,15038,89616
2023-07-01 00:00:00,0,24690,33411,515,0,0,6591,65207
2023-07-02 00:00:00,0,24189,32229,470,2,0,6171,63061
2023-07-03 00:00:00,0,24468,56713,440,2,0,18163,99786
2023-07-04 00:00:00,0,24924,55621,485,2,0,16531,97563
2023-07-05 00:00:00,0,25214,59893,477,1,0,16528,102113
2023-07-06 00:00:00,0,23792,63433,486,3,0,16265,103979
2023-07-07 00:00:00,0,24197,59191,441,0,0,14503,98332
2023-07-08 00:00:00,0,24268,38085,496,2,0,6563,69414
2023-07-09 00:00:00,0,25523,38562,568,0,0,6528,71181
2023-07-10 00:00:00,0,25753,64063,564,0,0,19918,110298
2023-07-11 00:00:00,0,26511,64969,512,0,0,18712,110704
2023-07-12 00:00:00,0,26273,67834,551,0,0,20938,115596
2023-07-13 00:00:00,0,26405,63083,411,0,0,18370,108269
2023-07-14 00:00:00,0,24638,54474,496,0,0,15132,94740
2023-07-15 00:00:00,0,28106,37831,450,0,0,6682,73069
2023-07-16 00:00:00,0,24133,34894,439,0,0,6046,65512
2023-07-17 00:00:00,0,25176,59997,472,3,0,17096,102744
2023-07-18 00:00:00,0,25845,87769,467,0,0,17266,131347
2023-07-19 00:00:00,0,25314,103489,529,2,0,16396,145730
2023-07-20 00:00:00,0,24583,62135,436,4,0,16204,103362
2023-07-21 00:00:00,0,23544,58204,538,1,0,14789,97076
2023-07-22 00:00:00,0,25658,40977,543,1,0,6305,73484
2023-07-23 00:00:00,0,24509,40031,533,4,0,6124,71201
2023-07-24 00:00:00,0,24297,66042,512,0,0,17729,108580
2023-07-25 00:00:00,0,30023,68680,618,1,0,16467,115789
2023-07-26 00:00:00,0,31792,59755,866,0,0,16320,108733
2023-07-27 00:00:00,0,31868,59680,787,0,0,15926,108261
2023-07-28 00:00:00,0,32122,58124,800,1,3,14494,105544
2023-07-29 00:00:00,0,33355,43744,871,0,2,6503,84475
2023-07-30 00:00:00,0,33943,43406,821,1,0,6146,84317
2023-07-31 00:00:00,0,33043,71756,783,0,0,17161,122743
2023-08-01 00:00:00,0,32347,75260,715,1,0,16333,124656
2023-08-02 00:00:00,0,31590,86896,734,0,0,16399,135619
2023-08-03 00:00:00,0,30069,88872,769,3,0,16427,136140
2023-08-04 00:00:00,0,28756,84441,682,0,0,15102,128981
2023-08-05 00:00:00,0,29602,64257,603,0,0,6679,101141
2023-08-06 00:00:00,0,29604,61566,629,0,0,6518,98317
2023-08-07 00:00:00,0,28915,94919,564,0,0,17240,141638
2023-08-08 00:00:00,0,28899,93426,592,0,0,16126,139043
2023-08-09 00:00:00,0,46217,97458,1081,0,0,17144,161900
2023-08-10 00:00:00,0,50990,91023,1090,1,0,14782,157886
2023-08-11 00:00:00,0,51042,85123,1186,0,27,12238,149616
2023-08-12 00:00:00,0,55044,68582,1173,1,0,5963,130763
2023-08-13 00:00:00,0,54980,62844,1109,1,0,5443,124377
2023-08-14 00:00:00,0,52848,91592,1115,1,0,13352,158908
2023-08-15 00:00:00,0,52180,82276,1228,0,0,11473,147157
2023-08-16 00:00:00,0,51838,90108,1103,4,0,14246,157299
2023-08-17 00:00:00,0,52353,89284,1073,3,0,14277,156990
